n:32-32-I think there's something wrong with the reactor;i:36-14;i:7-32;i:17-9
XXXXXXXXXXXXXXXXXXXXXXXXXXXXXXXXXXXXXXXXXXXXXXX
XXXXXXXXXXXXXXXXXXXXXXXXXXXXXXXXXXXXXXXXXXXXXXX
XXXXXXXXXXXXXXXXXXXXXXXXXXXXXXXX_____XXXXXXXXXX
XXXXXXXXXXXX                 XXX_____XXXXXXXXXX
XXXXXXXXXXXX                 XXX_____XXXXXXXXXX
XXXXXXXXXXXXXXXXXXXXXXXXXXXXXXXX_____XXXXXXXXXX
XXXXXXXXXXXXXXXXXXXXXXXXXXXXXXXXXX_XXXXXXXXXXXX
XXXXXXXXXXXXXXXXXXXXXXXXXXXXXXXXX___XXXXXXXXXXX
XXXXXXXXXXXXXXX___________XXXXXXX___XXXXXXXXXXX
XXXXXXXXXXXXXXX___________XXXXXXX___XXXX_____XX
XXXXXXXXXXXXXXX___@    ___XXXXXXX___XXXX_____XX
XXXXXXXXXXXXXXX___     ___XXXXXXX___XXXX_____XX
XXXXXXXXXXXXXXX___     ___XXXXXXX___XXXX_____XX
XXXXXXXXXXXXXXX___     ___XXXXXXX____________XX
XXXXXXXXXXXXXXX___     ___XXXXXXX___XXXX_____XX
XXXXXX____XXXXX___     ___XXXXXXX___XXXXXXXXXXX
XXXXXX____XXXXX_____________________XXXXXXXXXXX
XXXXXX______________________________XXXXXXXXXXX
XXXXXX____XXXXX___________XXXXXXX___XXXXXXXXXXX
XXXXXXXXXXXXXXXXXXXXXXXXXXXXXXXXX___XXXX_____XX
XXXXXXXXXXXXXXXXXXXXXXXXXXXXXXXXX____________XX
XXXXXXXXXXXXXXXXXXXXXXXXXXXXXXXXX___XXXX_____XX
XXXXXXXXXXXXXXXXXXXXTXXXXXXXXXXXX___XXXX_____XX
XXX_________________________________XXXXXXXXXXX
XXX_________________________________XXXXXXXXXXX
XXX_________________________________XXXXXXXXXXX
XXXXX__XXXXXXXXXXX__XXXXXXXXXXXXXXXXXXXXXXXXXXX
XXXXX__XXXXXXXXXXX__XXXXXXXXXXXXXXXXXXXXXXXXXXX
XXXXX__XXXXXXXXXXX__XXXXXXXXXXXXXXXXXXXXXXXXXXX
XX________XXXXXXX______XXXXXX________XXXXXXXXXX
XX________XXXXXXX______XXXXXX________XXXXXXXXXX
XX________XXXXXXX______XXXXXX________XXXXXXXXXX
XX________XXXXXXX____________________XXXXXXXXXX
XX________XXXXXXX______XXXXXX________XXXXXXXXXX
XX________XXXXXXXXXXXXXXXXXXX________XXXXXXXXXX
XXXXXXXXXXXXXXXXXXXXXXXXXXXXX________XXXXXXXXXX
XXXXXXXXXXXXXXXXXXXXXXXXXXXXXXXXXXXXXXXXXXXXXXX
XXXXXXXXXXXXXXXXXXXXXXXXXXXXXXXXXXXXXXXXXXXXXXX
