n:34-24-I think there's something wrong with the reactor;i:13-7;i:30-7

    XXXXXXXXXXXXXXXXXXXXXXXXXXXXXXXXXXXXXXXXXX
    XX_______________XXXXX_________XXXXXXXXXXX
    XX_______________XXXXX_________XXXXXXXXXXX
    XX_____________________________XXXXXXXXXXX
    XX_____________________________XXXXXXXXXXX
    XX_____________________________XXXXXXXXXXX
    XX_______________XXXXX_________XXXX_____XX
    XX_______________XXXXX_________XXXX_____XX
    XXXXXXXX___XXXXXXXXXXX__________________XX
    XXXXXXXX___XXXXXXXXXXX_________XXXX_____XX
    XXXXXXXX___XXXXXXXXXXX_________XXXX_____XX
    XX++_________++___XXXXXXXXXXXXXXXXXXXXXXXX
    XX___________+___+XXXXXXXXXXXXXXXXXXXXXXXX
    XX_______________+XXXXXXXXXXXXXXXXXXXXXXXX
    XX________________XXXXXXXXTXXXXXXXXXXXXXXXX
    XX___+++__________XXXX_________XXXXXXXXXXXX
    XX___+++__________XXXX_________XXXXXXXXXXXX
    XX___+++__________XXXX_________XXXXXXXXXXXX
    XX______________++XXXX_________XXXXXXXXXXXX
    XX______________++XXXX_________XXXXXXXXXXXX
    XX++______________XXXX_________XXXXX____XXX
    XX++______________XXXX_________XXXXX____XXX
    XX_____________________________XXXXX____XXX
    XX________________XXXXXXXXXXXXXXXXXX____XXX
    XX____________++__XXXXXXXXXXXXXXXXXX____XXX
    XXXXXX_XXXXXXXXXXXXXXXXXXXXXXXXXXXXXXXX_XXX
    XXXXXX_XXXXXXXXXXXXXXXXXXXXXXXXXXXXXXXX_XXX
    XXXXXX_XXXXXXXXXXXXXXXXXXXXXXXXXXXXXXXX_XXX
    XXXXXX_XXXXXXXXXXXXXXXXXXXXXXXXXXXXXXXX_XXX
    XXXXXX_XXXXXXXXXXXX__________XXXXX_______XX
    XXXXXX_XXXXXXXXXXXX__________XXXXX_______XX
    XXXXXX___________________________________XX
    XXXXXX_XXXXXXXXXXXX______________________XX
    XXXX_+_XXXXXXXXXXXX__________XXXXX_______XX
    XXXX___XXXXXXXXXXXX__________XXXXX_______XX
    XXXX+__XXXXXXXXXXXXXXXXXXXXXXXXXXXXXXXXXXXX
    XXXXXXXXXXXXXXXXXXXXXXXXXXXXXXXXXXXXXXXXXXX
